#tilemap file
width: 32
height: 20
#start: 7,2
#end: 16,7
tileset: images/tileset.png 32,32,16
map_begin
11111111111111111111111111111111
11000000000100000100000000000111
11000000000000000000000000000111
11111111111111001111111111111111
11111111111100000011111111111111
11100010000000000000000100001111
11000010000000000000000100001111
11000000000111111110000000001111
11000000000100000010000000001111
11000000000000000000000000001111
11000000000000000000000000001111
11001110000100000010000111001111
11000000000000000000000000001111
11000011111100000011111100001111
11000000000111001110000000001111
11000000000000001110000000001111
11000000000111000000000000001111
11000000000111001110000000001111
11000000000000000000000000001111
11111111111111111111111111111111
map_end

entity: Player
position: 2,1
entity_end
entity: Arrow
position: 1,1
entity_end
#entity: Corpse
#position: 25,4
#entity_end

entity: Archer
position: 15,8
patrol: 15,9
patrol: 8,9
patrol: 22,9
patrol: 15,18
patrol_end
retreat: 15,8
entity_end

entity: Archer
position: 5,16
patrol: 4,16
patrol: 12,18
patrol: 26,16
patrol: 26,8
patrol_end
retreat: 4,2
entity_end